11111111111111111111111
10001000000000000000001
10P01000000000000000001
10001000000000000000001
10001000000000000000001
1000100000000000000E001
10001000000000000000001
10000000000000000000001
11111111111111111111111