11111111111111111111111
10000000000000001000001
10P00000000000001000001
100000000C0000001000001
1000000C000000001000001
100000000C000000100E001
10000000000000001000001
10000000000000000000101
11111111111111111111111