11111111111111111111111111111111111111
1000C00000001000000C0000C000000C000001
10000000000010000000001000000100001C01
1000100C000010000000001000000100001001
1000100000001000000C001000000100001001
10P01000000010000000001000000100001C01
10001000000010000000001000000100001001
1000100C00001C00000C001000000100001001
10001000000000000000001000000100001E01
11111111111111111111111111111111111111