11111111111
10000P00001
10000000C01
1000E000001
11111111111
