11111111
11111111
11011111
1C1E11P1
1C101101
1CC00001
11111111

