11111111
1P100E01
10101001
10101001
1C101001
10001001
11111111