1111111
1P000E1
1000001
1000001
1000001
1000001
1111111